width: 15 
height: 15 
tileset: dungeon

layer: static
{
9 9 9 9 9 9 9 9 9 9 9 9 9 9 9
9 9 9 9 9 9 9 9 9 9 9 9 9 9 9
9 9 9 9 9 9 9 9 9 9 9 9 9 9 9
9 9 6 7 7 7 7 7 7 7 8 9 9 9 9
9 9 13 13 13 14 11 11 11 11 11 9 9 9 9
9 9 13 13 13 9 9 9 11 11 11 9 9 9 9
9 9 13 13 13 6 7 8 11 11 11 9 9 9 9
9 9 13 13 13 13 13 13 4 11 11 9 9 9 9
9 9 9 9 23 9 9 13 9 9 9 9 9 9 9
9 9 5 5 11 9 9 13 6 7 7 7 7 9 9
9 9 11 11 11 9 9 13 13 14 11 11 11 9 9
9 9 11 11 11 9 9 13 13 14 11 2 3 6 9
9 9 9 9 9 9 9 13 13 13 3 13 13 13 9
9 9 9 9 9 9 9 13 13 13 13 13 13 9 9
9 9 9 9 9 9 9 9 9 9 9 9 9 9 9
}

layer: static
{
1 1 1 1 1 1 1 1 1 1 1 1 1 1 1
1 1 1 1 1 1 1 1 1 1 1 1 1 1 1
1 1 1 1 1 1 1 1 1 1 1 1 1 1 1
1 1 1 1 1 1 1 1 1 1 1 1 1 1 1
1 1 1 1 1 1 1 1 1 1 1 1 1 1 1
1 1 1 1 1 1 1 1 20 1 1 1 1 1 1
1 1 1 1 1 1 1 1 10 1 1 1 1 1 1
1 1 1 1 1 1 1 1 1 1 1 1 1 1 1
1 1 1 1 20 1 1 20 1 1 1 1 1 1 1
1 1 1 1 10 1 1 10 1 1 1 1 1 1 1
1 1 1 1 1 1 1 10 1 1 1 1 1 1 1
1 1 1 1 1 1 1 10 1 1 1 1 1 1 1
1 1 1 1 1 1 1 10 1 1 1 1 1 1 1
1 1 1 1 1 1 1 10 1 1 1 1 1 1 1
1 1 1 1 1 1 1 1 1 1 1 1 1 1 1
}