width: 15 
height: 15 
tileset: room

layer: static
{
2 2 2 2 2 2 2 2 2 2 2 2 2 2 2
2 2 2 2 2 2 2 2 2 2 2 2 2 2 2
2 2 2 2 2 2 2 2 2 2 2 2 2 2 2
2 2 2 2 2 2 2 2 2 2 2 2 2 2 2
2 2 2 2 2 2 2 2 2 2 2 2 2 2 2
2 1 1 1 1 1 2 2 2 2 2 2 2 2 2
2 1 1 1 1 1 2 2 2 2 2 2 2 2 2
2 1 1 1 1 1 2 2 2 2 2 2 2 2 2
2 2 2 2 1 2 2 1 1 1 1 1 1 2 2
2 1 1 1 1 1 1 1 1 1 1 1 1 2 2
2 1 1 1 1 1 2 1 1 1 1 1 1 2 2
2 1 1 1 1 1 2 1 1 1 1 1 1 2 2
2 1 1 1 1 1 2 1 1 1 1 1 1 2 2
2 2 1 1 2 2 2 2 2 2 2 2 2 2 2
2 2 2 2 2 2 2 2 2 2 2 2 2 2 2
}
