width: 15 
height: 15 
tileset: Mockup

layer: static
{
1 1 1 1 1 1 1 1 1 1 1 1 1 1 1
1 1 1 1 1 1 1 1 1 1 1 1 1 1 1
1 1 1 1 1 1 1 1 1 1 1 1 1 1 1
1 1 1 1 1 1 1 1 1 1 1 1 1 1 1
1 2 2 2 2 2 2 2 2 2 2 2 2 1 1
1 4 4 4 4 4 4 4 4 4 4 4 4 1 1
1 5 5 5 5 5 5 5 5 5 5 5 5 1 1
1 5 5 5 5 5 5 5 5 5 5 5 5 1 1
1 5 5 5 5 5 5 5 5 5 5 5 5 1 1
1 1 1 1 1 1 1 1 1 1 1 1 1 1 1
1 1 1 1 1 1 1 1 1 1 1 1 1 1 1
1 1 1 1 1 1 1 1 1 1 1 1 1 1 1
1 1 1 1 1 1 1 1 1 1 1 1 1 1 1
1 1 1 1 1 1 1 1 1 1 1 1 1 1 1
1 1 1 1 1 1 1 1 1 1 1 1 1 1 1
}
